11111111111111111111111111111111111111111
1P000000000000000000000000000000000000001
10000000000000000000000000000000000000001
10000000000000000000000000000000000000001
10101010101010101010101010000000001111101
10000000000000000000001011111111111111101
10000000000000000000001011111111111111101
10000010000000000000001011000000000000001
10000000000000000000001011111111111111101
10000000000000000000001011111111111111101
10000000000000000000001C11111111111111101
10000000000000000000001000000000000000001
10000000000000000000001E11111111111111111
11111111111111111111111111111111111111111
