11111111111111111111111111111111111111111
1P001000000000000000000000000000000000001
11111000000000000C000000000000000C0000001
10000000000000000000000000000000000000001
10101010101010101010101010000C00001111101
10000000000000000000001011111111111111101
100000000000C0000000001011111111111111101
100000100000C000000000101100C000000000001
100000000000C0000000001011111111111111101
100000000000C0000000001011111111111111101
100000000000C0000000001011111111111111101
100000000000C0000000001000000000000000001
10000000000000000000001E11111111111111111
11111111111111111111111111111111111111111
